|||||||||||||||||||
|O|||||||||||||||||
| |||||||| ||||||||
| |||||||| ||||||||
| |||||||| |||$||||
| |||||||| ||| ||||
|              ||||
|||||||||||||||||||